%%%%%%%
% P   %
% %%% %
% %.  %
% %%% %
%.G   %
%%%%%%%