%%%%%%%%
%P     %
% .% . %
%  %   %
% .% .G%
%      %
%%%%%%%%